{
    "38광땡": 15,
    "암행어사": 14,
    "18광땡": 13,
    "13광땡": 13,
    "장땡": 12,
    "멍텅구리구사": 11,
    "땡잡이": 10,
    "9땡": 9,
    "8땡": 9,
    "7땡": 9,
    "6땡": 9,
    "5땡": 9,
    "4땡": 9,
    "3땡": 9,
    "2땡": 9,
    "1땡": 9,
    "구사": 8,
    "알리": 7,
    "독사": 6,
    "구삥": 5,
    "장삥": 4,
    "장사": 3,
    "세륙": 2,
    "갑오(9끗)": 1,
    "8끗": 1,
    "7끗": 1,
    "6끗": 1,
    "5끗": 1,
    "4끗": 1,
    "3끗": 1,
    "2끗": 1,
    "1끗": 1,
    "망통(0끗)": 1
}
